map
01 01 01 01 01 01 01 01 01 01 01 01 01 01 01 01 01 01 01 01 01 01 01 01
01 00 01 01 00 00 00 00 01 01 00 00 00 00 01 01 00 00 00 00 01 01 00 01
01 08 00 07 01 01 01 00 00 00 00 01 01 00 00 01 00 01 01 00 00 00 00 01
01 00 01 01 00 00 00 01 01 01 00 01 00 00 01 01 00 07 09 01 01 01 00 01
01 00 00 00 00 01 01 00 00 01 00 01 01 00 00 00 00 01 01 00 00 00 00 01
01 00 01 01 00 00 00 00 01 01 00 00 00 01 01 01 00 01 07 00 01 01 00 01
01 00 00 01 00 01 01 00 00 00 00 01 01 00 00 00 01 01 01 00 00 01 00 01
01 00 01 02 00 01 00 00 01 01 00 00 00 00 01 01 00 00 00 00 01 01 00 01
01 00 07 09 01 01 01 00 00 00 00 01 01 00 00 00 00 01 01 00 00 00 00 01
01 01 01 01 00 00 00 01 01 01 00 07 01 00 01 01 00 00 01 00 01 01 01 01
01 00 00 00 00 01 01 00 00 00 00 01 01 00 00 00 01 01 01 00 00 00 00 01
01 00 01 01 00 00 01 00 01 01 00 00 00 01 01 00 07 01 00 00 01 01 00 01
01 00 00 01 00 01 01 00 00 00 01 01 01 00 00 00 01 01 01 00 00 00 00 01
01 00 01 01 00 00 00 00 01 01 00 00 00 01 01 01 00 00 00 00 01 01 00 01
01 00 00 00 01 01 01 01 09 07 00 01 01 00 00 00 01 01 01 00 00 01 00 01
01 00 01 01 00 00 00 00 01 01 01 00 00 00 01 01 00 00 00 00 01 01 00 01
01 00 00 00 00 01 01 00 00 01 00 01 01 00 00 01 00 01 01 00 01 07 00 01
01 00 01 01 00 01 07 00 01 01 00 00 00 00 01 01 00 00 00 00 01 01 00 01
01 00 00 00 00 01 01 00 00 00 00 01 01 00 00 00 00 01 01 07 09 00 00 01
01 01 01 01 01 01 01 01 01 01 01 01 01 01 01 01 01 01 01 01 01 01 01 01
enemies
00 00 00 00 00 00 00 00 00 00 00 00 00 00 00 00 00 00 00 00 00 00 00 00
00 00 00 00 00 00 00 00 00 00 00 00 00 00 00 00 00 00 00 00 00 00 00 00
00 00 00 00 00 00 00 00 00 00 00 00 00 00 00 00 00 00 00 00 00 00 31 00
00 00 00 00 00 00 00 00 00 00 00 00 00 00 00 00 00 00 00 00 00 00 00 00
00 00 34 00 00 00 00 00 00 00 00 00 00 00 00 00 00 00 00 00 00 00 00 00
00 00 00 00 00 00 00 00 00 00 31 00 00 00 00 00 00 00 00 00 00 00 00 00
00 00 00 00 00 00 00 00 34 00 00 00 00 00 00 00 00 00 00 00 00 00 00 00
00 00 00 00 00 00 00 00 00 00 00 00 00 00 00 00 00 00 00 00 00 00 00 00
00 00 00 00 00 00 00 00 00 00 00 00 00 00 00 00 31 00 00 00 00 00 00 00
00 00 00 00 00 00 00 00 00 00 00 00 00 00 00 00 00 00 00 00 00 00 00 00
00 00 00 00 00 00 00 00 00 00 00 00 00 00 00 00 00 00 00 00 00 00 00 00
00 00 00 00 00 00 00 00 00 00 00 00 00 00 00 00 00 00 00 00 00 00 00 00
00 00 00 00 00 00 00 00 00 00 00 00 00 00 00 00 00 00 00 00 00 00 00 00
00 31 00 00 00 00 00 00 00 00 00 00 00 00 00 00 00 00 34 00 00 00 00 00
00 00 00 00 00 00 00 00 00 00 00 00 00 00 00 00 00 00 00 00 00 00 00 00
00 00 00 00 00 00 00 00 00 00 00 00 00 00 00 00 00 00 00 00 00 00 31 00
00 00 00 00 00 00 00 00 00 00 00 00 00 00 00 00 00 00 00 00 00 00 00 00
00 00 00 00 00 00 00 00 00 00 00 00 00 31 00 00 00 00 00 00 00 00 00 00
00 00 00 00 00 00 00 00 00 00 00 00 00 00 00 00 00 00 00 00 00 00 00 00
00 00 00 00 00 00 00 00 00 00 00 00 00 00 00 00 00 00 00 00 00 00 00 00
items
00 00 00 00 00 00 00 00 00 00 00 00 00 00 00 00 00 00 00 00 00 00 00 00
00 00 00 00 00 00 00 00 00 00 00 00 00 00 00 00 00 00 00 00 00 00 00 00
00 00 00 00 00 00 00 00 00 00 00 00 00 00 00 00 00 00 00 00 00 00 00 00
00 00 00 00 00 00 00 00 00 00 00 00 00 00 00 00 00 00 00 00 00 00 00 00
00 00 00 00 00 00 00 00 00 00 00 00 00 00 00 00 00 00 00 00 00 00 00 00
00 00 00 00 00 00 00 00 00 00 00 00 00 00 00 00 00 00 00 00 00 00 00 00
00 00 00 00 00 00 00 00 00 00 00 00 00 00 00 00 00 00 00 00 91 00 00 00
00 00 00 00 00 00 00 00 00 00 00 00 00 00 00 00 00 00 00 00 00 00 00 00
00 00 00 00 00 00 00 00 00 00 00 00 00 00 00 00 00 00 00 00 00 00 00 00
00 00 00 00 00 00 00 00 00 00 00 00 00 00 00 00 00 00 00 00 00 00 00 00
00 00 00 00 00 00 00 00 00 00 00 00 00 00 00 00 00 00 00 00 00 00 00 00
00 00 00 00 00 00 00 00 00 00 00 00 00 00 00 00 00 00 00 00 00 00 00 00
00 00 00 00 00 00 00 00 00 00 00 00 00 00 00 00 00 00 00 00 00 00 00 00
00 00 00 00 00 00 00 00 00 00 00 00 00 00 00 00 00 00 00 00 00 00 00 00
00 00 00 00 00 00 00 00 00 00 00 00 00 00 00 90 00 00 00 00 00 00 00 00
00 00 00 00 00 00 00 00 00 00 00 00 00 00 00 00 00 00 00 00 00 00 00 00
00 00 00 00 00 00 00 00 00 00 00 00 00 00 00 00 00 00 00 00 00 00 00 00
00 00 00 00 00 00 00 00 00 00 00 00 00 00 00 00 00 00 00 00 00 00 00 00
00 00 00 00 00 00 00 00 00 00 00 00 00 00 00 00 00 00 00 00 00 00 00 00
00 00 00 00 00 00 00 00 00 00 00 00 00 00 00 00 00 00 00 00 00 00 00 00
