01 01 01 01 01 01 01 01 01 01 01 01 01 01 01 01 01 01 01 01 01 01 01 01
01 00 00 00 00 00 00 00 00 00 00 00 07 01 00 00 01 01 00 01 01 00 91 01
01 33 00 00 00 00 00 00 00 00 00 00 00 01 00 00 01 00 09 00 01 00 00 01
01 00 00 00 00 00 01 01 00 00 00 00 01 01 00 00 00 00 00 00 34 00 00 01
01 00 00 00 00 00 01 00 00 34 00 00 07 01 00 00 33 00 00 00 00 00 00 01
01 00 00 00 00 00 01 07 00 00 00 00 02 02 00 00 00 00 31 00 00 00 00 01
01 00 00 00 00 00 34 01 00 00 00 33 01 01 01 01 01 01 00 01 01 01 01 01
01 00 00 00 00 00 01 01 00 00 00 00 01 01 00 00 00 01 00 01 00 00 00 01
01 00 00 00 00 00 01 01 00 00 00 00 00 01 00 00 01 01 00 01 01 00 00 01
01 00 00 00 00 00 00 01 33 00 00 00 07 07 00 00 00 00 00 00 00 00 00 01
01 00 00 00 00 00 34 07 00 00 00 00 00 01 00 00 00 00 00 00 00 00 00 01
01 00 00 00 00 00 00 01 00 00 00 00 01 01 00 00 00 00 00 00 00 00 00 01
01 00 00 00 00 00 01 01 00 00 00 00 01 01 00 00 00 00 00 00 00 00 00 01
01 00 00 00 00 00 01 01 00 00 00 00 01 01 00 00 34 00 01 01 01 01 01 01
01 00 00 00 00 00 01 01 00 00 00 00 01 01 00 00 00 00 01 00 01 07 05 01
01 00 00 00 00 00 01 01 00 00 00 00 07 01 00 00 00 00 01 00 00 00 00 01
01 00 00 08 00 00 01 00 00 00 34 00 00 01 00 00 00 00 01 30 01 01 00 01
01 00 00 00 00 00 07 01 00 00 00 00 00 00 00 00 00 00 01 00 01 00 00 01
01 00 00 00 00 00 00 01 00 00 00 00 00 00 00 00 00 34 00 00 01 07 90 01
01 01 01 01 01 01 01 01 01 01 01 01 01 01 01 01 01 01 01 01 01 01 01 01
