1 1 1 1 1 1 1 1 1 1 1 1 1 1 1 1 1 1 1 1 1 1 1 1
1 1 1 1 1 1 1 1 1 7 0 1 1 0 0 1 9 0 0 0 0 0 0 1
1 1 0 0 7 0 7 1 1 0 0 0 8 0 0 1 1 1 1 1 7 0 1 1
1 1 0 7 0 0 0 1 1 0 0 0 0 0 0 1 0 0 0 0 0 0 0 1
1 1 0 0 0 7 0 1 1 0 7 1 1 0 0 1 0 7 1 1 1 1 1 1
1 1 7 0 9 0 7 1 1 0 0 1 1 0 0 1 0 0 0 0 0 0 0 1
1 1 0 0 0 0 0 2 2 0 0 7 1 0 0 1 1 1 1 1 7 0 1 1
1 1 7 0 0 7 0 1 1 0 0 0 6 0 0 0 0 0 0 0 0 0 0 1
1 1 0 7 0 0 7 1 1 4 0 1 1 0 0 1 1 0 7 1 1 1 1 1
1 1 1 1 1 1 1 1 1 0 0 1 1 0 0 0 0 0 0 0 0 0 0 1
1 1 1 1 1 1 1 1 1 0 1 1 1 7 0 1 1 1 1 1 1 1 1 1
1 0 0 0 0 6 0 0 0 0 0 0 0 0 0 0 0 0 0 0 0 0 0 1
1 0 1 1 1 0 0 1 0 0 0 0 1 1 1 0 0 1 0 0 1 0 0 1
1 0 1 0 1 0 0 1 0 0 0 1 0 0 0 1 0 1 0 7 1 7 0 1
1 0 1 1 1 0 0 1 0 0 0 1 1 1 1 1 7 1 0 0 1 0 0 1
1 0 1 0 9 1 0 1 0 0 0 1 0 9 0 1 0 1 7 0 1 0 0 1
1 0 1 0 0 1 7 1 0 0 0 1 0 0 7 1 0 1 0 5 1 0 0 1
1 0 1 1 1 1 0 1 1 1 7 1 7 0 0 1 0 1 1 1 1 0 0 1
1 0 0 0 0 0 0 0 0 0 0 0 0 0 0 0 0 0 0 0 0 0 0 1
1 1 1 1 1 1 1 1 1 1 1 1 1 1 1 1 1 1 1 1 1 1 1 1
