1 1 1 1 1 1 1 1 1 1 1 1 1 1 1 1 1 1 1 1 1 1 1 1
1 0 0 0 0 1 9 0 0 0 0 0 0 0 0 0 0 0 1 1 0 0 0 1
1 0 1 1 0 1 1 2 1 1 7 1 1 1 1 1 1 0 0 1 0 1 0 1
1 0 0 1 0 0 0 0 0 0 0 0 0 0 0 0 1 1 0 1 0 1 0 1
1 1 0 1 1 1 1 2 1 1 1 1 1 1 1 0 1 0 0 0 0 1 0 1
1 0 0 1 0 0 0 0 0 0 0 0 0 0 1 0 1 1 1 1 1 1 0 1
1 0 1 1 0 1 1 2 1 1 1 1 1 0 1 0 0 0 1 7 9 1 0 1
1 0 1 0 0 1 0 0 0 0 0 0 1 0 1 1 1 0 1 0 1 1 0 1
1 0 1 0 1 0 0 1 1 1 1 0 1 0 1 0 0 0 1 0 0 0 0 1
1 0 1 0 1 0 0 1 1 8 1 0 1 0 1 0 1 1 1 1 1 0 1 1
1 0 1 0 1 7 0 1 1 0 1 0 1 0 1 0 0 0 0 0 1 0 0 1
1 0 1 0 1 0 0 1 1 0 0 0 1 0 1 1 1 1 1 0 1 1 0 1
1 0 1 0 1 0 0 1 1 1 1 1 1 0 7 9 1 0 0 0 1 0 0 1
1 0 1 0 1 0 0 0 0 0 0 0 0 0 1 0 1 0 1 1 1 0 1 1
1 0 1 0 1 1 1 1 1 1 1 1 1 0 1 1 1 0 1 0 0 0 1 1
1 0 1 0 0 0 0 0 0 0 0 0 0 0 0 0 1 0 1 0 1 1 1 1
1 0 1 1 1 1 1 1 1 1 1 1 1 1 1 0 7 0 1 0 0 0 0 1
1 0 0 0 0 1 1 7 0 0 1 1 0 0 0 0 1 0 1 1 1 1 0 1
1 1 1 1 0 0 0 0 0 0 0 0 0 1 1 1 1 0 0 0 0 0 0 1
1 1 1 1 1 1 1 1 1 1 1 1 1 1 1 1 1 1 1 1 1 1 1 1
