01 01 01 01 01 01 01 01 01 01 01 01 01 01 01 01 01 01 01 01 01 01 01 01
01 01 01 01 01 01 01 01 01 00 00 08 00 00 00 01 01 01 01 01 01 01 01 01
01 01 01 01 01 01 01 01 01 00 00 00 00 00 00 01 01 01 01 01 01 01 01 01
01 01 01 01 01 01 01 01 01 00 00 00 00 33 00 01 01 01 01 01 01 01 01 01
01 01 01 00 00 00 00 00 00 00 00 00 00 00 00 00 00 00 00 33 00 01 01 01
01 01 01 91 00 00 00 00 33 00 00 00 00 00 00 00 00 00 00 00 00 01 01 01
01 01 01 00 00 33 00 00 00 00 00 00 00 00 00 00 00 00 00 00 90 01 01 01
01 01 01 00 00 00 00 00 00 00 00 00 00 00 00 00 33 00 00 00 00 01 01 01
01 01 01 01 01 01 01 01 01 00 34 00 00 00 00 01 01 01 01 01 01 01 01 01
01 01 01 01 01 01 01 01 01 00 00 00 33 00 00 01 01 01 01 01 01 01 01 01
01 01 01 01 01 01 01 01 01 00 00 00 00 00 00 01 01 01 01 01 01 01 01 01
01 01 01 01 01 01 01 01 01 34 00 00 00 00 00 01 01 01 01 01 01 01 01 01
01 01 01 01 01 01 01 01 01 00 00 00 00 00 33 01 01 01 01 01 01 01 01 01
01 01 01 01 01 01 01 01 01 00 00 00 00 00 00 01 01 01 01 01 01 01 01 01
01 01 01 01 01 01 01 01 01 00 00 00 00 34 00 01 01 01 01 01 01 01 01 01
01 01 01 01 01 01 01 01 01 01 01 00 01 01 01 01 01 01 01 01 01 01 01 01
01 01 01 01 01 01 01 01 01 00 00 00 00 00 00 01 01 01 01 01 01 01 01 01
01 01 01 01 01 01 01 01 01 00 00 31 00 00 00 01 01 01 01 01 01 01 01 01
01 01 01 01 01 01 01 01 01 00 00 00 09 00 00 01 01 01 01 01 01 01 01 01
01 01 01 01 01 01 01 01 01 01 01 01 01 01 01 01 01 01 01 01 01 01 01 01
