01 01 01 01 01 01 01 01 01 01 01 01 01 01 01 01 01 01 01 01 01 01 01 01
01 01 00 00 00 00 01 09 01 01 00 00 01 01 00 00 00 00 00 00 00 00 01 01
01 00 00 05 00 01 01 07 01 00 00 00 00 01 00 01 01 00 07 00 00 00 00 01
01 00 00 08 00 00 00 00 03 00 01 00 00 00 00 00 01 00 01 00 00 01 00 01
01 00 00 00 00 00 01 33 00 00 00 00 01 00 01 00 00 00 00 00 01 01 00 01
01 00 01 01 07 00 00 00 01 01 00 00 01 00 00 00 00 01 00 00 01 07 00 01
01 00 00 01 00 00 00 01 01 01 00 01 01 01 00 01 00 00 00 00 01 01 07 01
01 00 00 00 00 00 01 01 00 00 00 00 00 01 00 00 00 07 00 00 00 01 00 01
01 00 01 01 01 00 00 01 00 01 01 00 07 01 00 01 00 01 01 00 00 01 09 01
01 00 00 00 33 00 00 00 00 01 00 31 09 01 01 01 00 00 01 01 00 01 00 01
01 00 00 01 00 00 00 01 00 00 00 00 00 01 00 00 00 00 07 91 33 01 30 01
01 00 01 01 01 00 01 01 01 01 01 00 01 01 00 00 07 00 01 01 00 01 00 01
01 00 00 00 00 00 00 00 01 01 00 00 00 01 01 00 01 00 00 00 00 01 00 01
01 00 00 01 00 00 07 00 01 00 00 00 00 00 01 00 00 00 01 01 00 00 00 01
01 00 01 01 01 00 00 00 00 00 01 00 00 00 00 00 00 00 00 07 00 01 01 01
01 00 00 01 01 00 00 01 07 01 01 00 01 01 00 07 00 00 01 01 00 00 00 01
01 00 07 01 01 01 00 01 01 01 00 00 00 01 00 00 00 00 01 00 00 30 00 01
01 00 00 00 00 01 01 01 00 09 01 00 00 01 00 01 00 00 00 00 01 00 90 01
01 01 00 01 00 07 00 00 00 33 00 00 00 00 00 00 00 01 07 00 00 00 01 01
01 01 01 01 01 01 01 01 01 01 01 01 01 01 01 01 01 01 01 01 01 01 01 01
