1 1 1 1 1 1 1 1 1 1 1 1 1 1 1 1 1 1 1 1 1 1 1 1
1 0 0 0 0 0 0 0 0 0 0 0 7 1 0 0 1 1 0 1 1 0 0 1
1 6 0 0 0 0 0 0 0 0 0 0 0 1 0 0 1 0 9 0 1 0 0 1
1 0 0 0 0 0 1 1 0 0 0 0 1 1 0 0 0 0 0 0 0 0 0 1
1 0 0 0 0 0 1 0 0 6 0 0 7 1 0 0 0 0 0 0 0 0 0 1
1 0 0 0 0 0 1 7 0 0 0 0 2 2 0 0 0 0 4 0 0 0 0 1
1 0 0 0 0 0 6 1 0 0 0 0 1 1 1 1 1 1 0 1 1 1 1 1
1 0 0 0 0 0 1 1 0 0 0 0 1 1 0 0 0 1 0 1 0 0 0 1
1 0 0 0 0 0 1 1 0 0 0 0 0 1 0 0 1 1 0 1 1 0 0 1
1 0 0 0 0 0 0 1 6 0 0 0 7 7 0 0 0 0 0 0 0 0 0 1
1 0 0 0 0 0 6 7 0 0 0 0 0 1 0 0 0 0 0 0 0 0 0 1
1 0 0 0 0 0 0 1 0 0 0 0 1 1 0 0 0 0 0 0 0 0 0 1
1 0 0 0 0 0 1 1 0 0 0 0 1 1 0 0 0 0 0 0 0 0 0 1
1 0 0 0 0 0 1 1 0 0 0 0 1 1 0 0 6 0 1 1 1 1 1 1
1 0 0 0 0 0 1 1 0 0 0 0 1 1 0 0 0 0 1 0 0 0 5 1
1 0 0 0 0 0 1 1 0 0 0 0 7 1 0 0 0 0 1 0 0 0 0 1
1 0 0 8 0 0 1 0 0 0 6 0 0 1 0 0 0 0 1 4 0 7 1 1
1 0 0 0 0 0 7 1 0 0 0 0 0 0 0 0 0 0 1 0 0 0 0 1
1 0 0 0 0 0 0 1 0 0 0 0 0 0 0 0 0 0 0 0 0 0 0 1
1 1 1 1 1 1 1 1 1 1 1 1 1 1 1 1 1 1 1 1 1 1 1 1
