01 01 01 01 01 01 01 01 01 01 01 01 01 01 01 01 01 01 01 01 01 01 01 01
01 00 00 00 00 01 09 00 00 00 00 00 00 00 00 00 00 00 01 01 00 00 00 01
01 00 01 01 00 01 01 02 01 01 07 01 01 01 01 01 01 00 00 01 00 01 00 01
01 00 00 01 00 00 00 00 00 00 04 00 00 00 00 00 01 01 00 01 00 01 00 01
01 01 00 01 01 01 01 02 01 01 01 01 01 01 01 00 01 00 00 00 00 01 00 01
01 00 00 01 00 00 00 00 00 00 00 00 00 00 01 00 01 01 01 01 01 01 00 01
01 00 01 01 00 01 01 02 01 01 01 01 01 00 01 00 00 00 01 07 09 01 00 01
01 00 01 00 00 01 00 00 00 00 00 00 01 00 01 01 01 00 01 00 01 01 00 01
01 00 01 00 01 00 00 01 01 01 01 00 01 00 01 00 00 00 06 00 00 00 00 01
01 00 01 00 01 00 00 01 01 08 01 00 01 00 01 00 01 01 01 01 01 00 01 01
01 00 01 00 01 07 00 01 01 00 01 00 01 00 01 00 00 00 00 00 01 00 00 01
01 00 01 00 01 00 00 01 01 00 00 00 01 00 01 01 01 01 01 00 01 01 00 01
01 00 01 00 01 00 00 01 01 01 01 01 01 00 07 09 01 00 00 00 01 00 00 01
01 00 01 00 01 00 00 00 00 00 00 00 00 00 01 00 01 00 01 01 01 00 01 01
01 00 01 00 01 01 01 01 01 01 01 01 01 00 01 01 01 00 01 00 00 00 01 01
01 00 01 00 00 00 00 00 00 00 00 00 00 00 00 00 01 00 01 00 01 01 01 01
01 00 01 01 01 01 01 01 01 01 01 01 01 01 01 00 07 00 01 00 00 00 00 01
01 00 00 00 00 01 01 07 00 00 01 01 00 00 00 00 01 00 01 01 01 01 00 01
01 01 01 01 00 00 00 00 00 06 00 00 00 01 01 01 01 00 00 00 00 00 00 01
01 01 01 01 01 01 01 01 01 01 01 01 01 01 01 01 01 01 01 01 01 01 01 01
