map
01 01 01 01 01 01 01 01 01 01 01 01 01 01 01 01 01 01 01 01 01 01 01 01
01 01 00 00 00 00 01 09 01 01 00 00 01 01 00 00 00 00 00 00 00 00 01 01
01 00 00 05 00 01 01 07 01 00 00 00 00 01 00 01 01 00 07 00 00 00 00 01
01 00 00 08 00 00 00 00 03 00 01 00 00 00 00 00 01 00 01 00 00 01 00 01
01 00 00 00 00 00 01 00 00 00 00 00 01 00 01 00 00 00 00 00 01 01 00 01
01 00 01 01 07 00 00 00 01 01 00 00 01 00 00 00 00 01 00 00 01 07 00 01
01 00 00 01 00 00 00 01 01 01 00 01 01 01 00 01 00 00 00 00 01 01 07 01
01 00 00 00 00 00 01 01 00 00 00 00 00 01 00 00 00 07 00 00 00 01 00 01
01 00 01 01 01 00 00 01 00 01 01 00 07 01 00 01 00 01 01 00 00 01 09 01
01 00 00 00 00 00 00 00 00 01 00 00 09 01 01 01 00 00 01 01 00 01 00 01
01 00 00 01 04 00 00 01 00 00 00 00 00 01 00 00 00 00 07 00 00 01 00 01
01 00 01 01 01 00 01 01 01 01 01 00 01 01 00 00 07 00 01 01 00 01 00 01
01 00 00 00 00 00 00 00 01 01 00 00 00 01 01 00 01 00 00 00 00 01 00 01
01 00 00 01 00 00 07 00 01 00 00 00 00 00 01 00 00 00 01 01 00 00 00 01
01 00 01 01 01 00 00 00 00 00 01 00 00 00 00 00 00 00 00 07 00 01 01 01
01 00 00 01 01 00 00 01 07 01 01 00 01 01 00 07 00 00 01 01 00 00 00 01
01 00 07 01 01 01 00 01 01 01 00 00 00 01 00 00 00 00 01 00 00 00 00 01
01 00 00 00 00 01 01 01 00 09 01 00 00 01 00 01 00 00 00 00 01 00 00 01
01 01 00 01 00 07 00 00 00 00 00 00 00 00 00 00 00 01 07 00 00 00 01 01
01 01 01 01 01 01 01 01 01 01 01 01 01 01 01 01 01 01 01 01 01 01 01 01
enemies
00 00 00 00 00 00 00 00 00 00 00 00 00 00 00 00 00 00 00 00 00 00 00 00
00 00 00 00 00 00 00 00 00 00 00 00 00 00 00 00 00 00 00 00 00 00 00 00
00 00 00 00 00 00 00 00 00 00 00 00 00 00 00 00 00 00 00 00 00 00 00 00
00 00 00 00 00 00 00 00 00 00 00 00 00 00 00 00 00 00 00 00 00 00 00 00
00 00 00 00 00 00 00 33 00 00 00 00 00 00 00 00 00 00 00 00 00 00 00 00
00 00 00 00 00 00 00 00 00 00 00 00 00 00 00 00 00 00 00 00 00 00 00 00
00 00 00 00 00 00 00 00 00 00 00 00 00 00 00 00 00 00 00 00 00 00 00 00
00 00 00 00 00 00 00 00 00 00 00 00 00 00 00 00 00 00 00 00 00 00 00 00
00 00 00 00 00 00 00 00 00 00 00 00 00 00 00 00 00 00 00 00 00 00 00 00
00 00 00 00 33 00 00 00 00 00 00 31 00 00 00 00 00 00 00 00 00 00 00 00
00 00 00 00 00 00 00 00 00 00 00 00 00 00 00 00 00 00 00 00 33 00 30 00
00 00 00 00 00 00 00 00 00 00 00 00 00 00 00 00 00 00 00 00 00 00 00 00
00 00 00 00 00 00 00 00 00 00 00 00 00 00 00 00 00 00 00 00 00 00 00 00
00 00 00 00 00 00 00 00 00 00 00 00 00 00 00 00 00 00 00 00 00 00 00 00
00 00 00 00 00 00 00 00 00 00 00 00 00 00 00 00 00 00 00 00 00 00 00 00
00 00 00 00 00 00 00 00 00 00 00 00 00 00 00 00 00 00 00 00 00 00 00 00
00 00 00 00 00 00 00 00 00 00 00 00 00 00 00 00 00 00 00 00 00 30 00 00
00 00 00 00 00 00 00 00 00 00 00 00 00 00 00 00 00 00 00 00 00 00 00 00
00 00 00 00 00 00 00 00 00 33 00 00 00 00 00 00 00 00 00 00 00 00 00 00
00 00 00 00 00 00 00 00 00 00 00 00 00 00 00 00 00 00 00 00 00 00 00 00
items
00 00 00 00 00 00 00 00 00 00 00 00 00 00 00 00 00 00 00 00 00 00 00 00
00 00 00 00 00 00 00 00 00 00 00 00 00 00 00 00 00 00 00 00 00 00 00 00
00 00 00 00 00 00 00 00 00 00 00 00 00 00 00 00 00 00 00 00 00 00 00 00
00 00 00 00 00 00 00 00 00 00 00 00 00 00 00 00 00 00 00 00 00 00 00 00
00 00 00 00 00 00 00 00 00 00 00 00 00 00 00 00 00 00 00 00 00 00 00 00
00 00 00 00 00 00 00 00 00 00 00 00 00 00 00 00 00 00 00 00 00 00 00 00
00 00 00 00 00 00 00 00 00 00 00 00 00 00 00 00 00 00 00 00 00 00 00 00
00 00 00 00 00 00 00 00 00 00 00 00 00 00 00 00 00 00 00 00 00 00 00 00
00 00 00 00 00 00 00 00 00 00 00 00 00 00 00 00 00 00 00 00 00 00 00 00
00 00 00 00 00 00 00 00 00 00 00 00 00 00 00 00 00 00 00 00 00 00 00 00
00 00 00 00 00 00 00 00 00 00 00 00 00 00 00 00 00 00 00 91 00 00 00 00
00 00 00 00 00 00 00 00 00 00 00 00 00 00 00 00 00 00 00 00 00 00 00 00
00 00 00 00 00 00 00 00 00 00 00 00 00 00 00 00 00 00 00 00 00 00 00 00
00 00 00 00 00 00 00 00 00 00 00 00 00 00 00 00 00 00 00 00 00 00 00 00
00 00 00 00 00 00 00 00 00 00 00 00 00 00 00 00 00 00 00 00 00 00 00 00
00 00 00 00 00 00 00 00 00 00 00 00 00 00 00 00 00 00 00 00 00 00 00 00
00 00 00 00 00 00 00 00 00 00 00 00 00 00 00 00 00 00 00 00 00 00 00 00
00 00 00 00 00 00 00 00 00 00 00 00 00 00 00 00 00 00 00 00 00 00 90 00
00 00 00 00 00 00 00 00 00 00 00 00 00 00 00 00 00 00 00 00 00 00 00 00
00 00 00 00 00 00 00 00 00 00 00 00 00 00 00 00 00 00 00 00 00 00 00 00
