map
01 01 01 01 01 01 01 01 01 01 01 01 01 01 01 01 01 01 01 01 01 01 01 01
01 00 00 00 00 00 00 00 00 00 00 00 07 01 00 00 01 01 00 01 01 00 00 01
01 00 00 00 00 00 00 00 00 00 00 00 00 01 00 00 01 00 09 00 01 00 00 01
01 00 00 00 00 00 01 01 00 00 00 00 01 01 00 00 00 00 00 00 00 00 00 01
01 00 00 00 00 00 01 00 00 00 00 00 07 01 00 00 00 00 00 00 00 00 00 01
01 00 00 00 00 00 01 07 00 00 00 00 02 02 00 00 00 00 00 00 00 00 00 01
01 00 00 00 00 00 00 01 00 00 00 00 01 01 01 01 01 01 00 01 01 01 01 01
01 00 00 00 00 00 01 01 00 00 00 00 01 01 00 00 00 01 00 01 00 00 00 01
01 00 00 00 00 00 01 01 00 00 00 00 00 01 00 00 01 01 00 01 01 00 00 01
01 00 00 00 00 00 00 01 00 00 00 00 07 07 00 00 00 00 00 00 00 00 00 01
01 00 00 00 00 00 00 07 00 00 00 00 00 01 00 00 00 00 00 00 00 00 00 01
01 00 00 00 00 00 00 01 00 00 00 00 01 01 00 00 00 00 00 00 00 00 00 01
01 00 00 00 00 00 01 01 00 00 00 00 01 01 00 00 00 00 00 00 00 00 00 01
01 00 00 00 00 00 01 01 00 00 00 00 01 01 00 00 00 00 01 01 01 01 01 01
01 00 00 00 00 00 01 01 00 00 00 00 01 01 00 00 00 00 01 00 01 07 05 01
01 00 00 00 00 00 01 01 00 00 00 00 07 01 00 00 00 00 01 00 00 00 00 01
01 00 00 08 00 00 01 00 00 00 00 00 00 01 00 00 00 00 01 00 01 01 00 01
01 00 00 00 00 00 07 01 00 00 00 00 00 00 00 00 00 00 01 00 01 00 00 01
01 00 00 00 00 00 00 01 00 00 00 00 00 00 00 00 00 00 00 00 01 07 00 01
01 01 01 01 01 01 01 01 01 01 01 01 01 01 01 01 01 01 01 01 01 01 01 01
enemies
00 00 00 00 00 00 00 00 00 00 00 00 00 00 00 00 00 00 00 00 00 00 00 00
00 00 00 00 00 00 00 00 00 00 00 00 00 00 00 00 00 00 00 00 00 00 00 00
00 33 00 00 00 00 00 00 00 00 00 00 00 00 00 00 00 00 00 00 00 00 00 00
00 00 00 00 00 00 00 00 00 00 00 00 00 00 00 00 00 00 00 00 34 00 00 00
00 00 00 00 00 00 00 00 00 34 00 00 00 00 00 00 33 00 00 00 00 00 00 00
00 00 00 00 00 00 00 00 00 00 00 00 00 00 00 00 00 00 31 00 00 00 00 00
00 00 00 00 00 00 34 00 00 00 00 33 00 00 00 00 00 00 00 00 00 00 00 00
00 00 00 00 00 00 00 00 00 00 00 00 00 00 00 00 00 00 00 00 00 00 00 00
00 00 00 00 00 00 00 00 00 00 00 00 00 00 00 00 00 00 00 00 00 00 00 00
00 00 00 00 00 00 00 00 33 00 00 00 00 00 00 00 00 00 00 00 00 00 00 00
00 00 00 00 00 00 34 00 00 00 00 00 00 00 00 00 00 00 00 00 00 00 00 00
00 00 00 00 00 00 00 00 00 00 00 00 00 00 00 00 00 00 00 00 00 00 00 00
00 00 00 00 00 00 00 00 00 00 00 00 00 00 00 00 00 00 00 00 00 00 00 00
00 00 00 00 00 00 00 00 00 00 00 00 00 00 00 00 34 00 00 00 00 00 00 00
00 00 00 00 00 00 00 00 00 00 00 00 00 00 00 00 00 00 00 00 00 00 00 00
00 00 00 00 00 00 00 00 00 00 00 00 00 00 00 00 00 00 00 00 00 00 00 00
00 00 00 00 00 00 00 00 00 00 34 00 00 00 00 00 00 00 00 30 00 00 00 00
00 00 00 00 00 00 00 00 00 00 00 00 00 00 00 00 00 00 00 00 00 00 00 00
00 00 00 00 00 00 00 00 00 00 00 00 00 00 00 00 00 34 00 00 00 00 00 00
00 00 00 00 00 00 00 00 00 00 00 00 00 00 00 00 00 00 00 00 00 00 00 00
items
00 00 00 00 00 00 00 00 00 00 00 00 00 00 00 00 00 00 00 00 00 00 00 00
00 00 00 00 00 00 00 00 00 00 00 00 00 00 00 00 00 00 00 00 00 00 91 00
00 00 00 00 00 00 00 00 00 00 00 00 00 00 00 00 00 00 00 00 00 00 00 00
00 00 00 00 00 00 00 00 00 00 00 00 00 00 00 00 00 00 00 00 00 00 00 00
00 00 00 00 00 00 00 00 00 00 00 00 00 00 00 00 00 00 00 00 00 00 00 00
00 00 00 00 00 00 00 00 00 00 00 00 00 00 00 00 00 00 00 00 00 00 00 00
00 00 00 00 00 00 00 00 00 00 00 00 00 00 00 00 00 00 00 00 00 00 00 00
00 00 00 00 00 00 00 00 00 00 00 00 00 00 00 00 00 00 00 00 00 00 00 00
00 00 00 00 00 00 00 00 00 00 00 00 00 00 00 00 00 00 00 00 00 00 00 00
00 00 00 00 00 00 00 00 00 00 00 00 00 00 00 00 00 00 00 00 00 00 00 00
00 00 00 00 00 00 00 00 00 00 00 00 00 00 00 00 00 00 00 00 00 00 00 00
00 00 00 00 00 00 00 00 00 00 00 00 00 00 00 00 00 00 00 00 00 00 00 00
00 00 00 00 00 00 00 00 00 00 00 00 00 00 00 00 00 00 00 00 00 00 00 00
00 00 00 00 00 00 00 00 00 00 00 00 00 00 00 00 00 00 00 00 00 00 00 00
00 00 00 00 00 00 00 00 00 00 00 00 00 00 00 00 00 00 00 00 00 00 00 00
00 00 00 00 00 00 00 00 00 00 00 00 00 00 00 00 00 00 00 00 00 00 00 00
00 00 00 00 00 00 00 00 00 00 00 00 00 00 00 00 00 00 00 00 00 00 00 00
00 00 00 00 00 00 00 00 00 00 00 00 00 00 00 00 00 00 00 00 00 00 00 00
00 00 00 00 00 00 00 00 00 00 00 00 00 00 00 00 00 00 00 00 00 00 90 00
00 00 00 00 00 00 00 00 00 00 00 00 00 00 00 00 00 00 00 00 00 00 00 00
