1 1 1 1 1 1 1 1 1 1 1 1 1 1 1 1 1 1 1 1 1 1 1 1
1 0 1 1 0 0 0 0 1 1 0 0 0 0 1 1 0 0 0 0 1 1 0 1
1 8 0 7 1 1 1 0 0 0 0 1 1 0 0 1 0 1 1 0 0 0 4 1
1 0 1 1 0 0 0 1 1 1 0 1 0 0 1 1 0 7 9 1 1 1 0 1
1 0 6 0 0 1 1 0 0 1 0 1 1 0 0 0 0 1 1 0 0 0 0 1
1 0 1 1 0 0 0 0 1 1 4 0 0 1 1 1 0 1 7 0 1 1 0 1
1 0 0 1 0 1 1 0 6 0 0 1 1 0 0 0 1 1 1 0 0 1 0 1
1 0 1 2 0 1 0 0 1 1 0 0 0 0 1 1 0 0 0 0 1 0 0 1
1 0 7 9 1 1 1 0 0 0 0 1 1 0 0 0 4 1 1 0 0 0 0 1
1 1 1 1 0 0 0 1 1 1 0 7 1 0 1 1 0 0 1 0 1 1 1 1
1 0 0 0 0 1 1 0 0 0 0 1 1 0 0 0 1 1 1 0 0 0 0 1
1 0 1 1 0 0 1 0 1 1 0 0 0 1 1 0 7 1 0 0 1 1 0 1
1 0 0 1 0 1 1 0 0 0 1 1 1 0 0 0 1 1 1 0 0 0 0 1
1 4 1 1 0 0 0 0 1 1 0 0 0 1 1 1 0 0 6 0 1 1 0 1
1 0 0 0 1 1 1 1 9 7 0 1 1 0 0 0 1 1 1 0 0 1 0 1
1 0 1 1 0 0 0 0 1 1 1 0 0 0 1 1 0 0 0 0 1 1 4 1
1 0 0 0 0 1 1 0 0 1 0 1 1 0 0 1 0 1 1 0 1 7 0 1
1 0 1 1 0 1 7 0 1 1 0 0 0 4 1 1 0 0 0 0 1 1 0 1
1 0 0 0 0 1 1 0 0 0 0 1 1 0 0 0 0 1 1 7 9 0 0 1
1 1 1 1 1 1 1 1 1 1 1 1 1 1 1 1 1 1 1 1 1 1 1 1
