01 01 01 01 01 01 01 01 01 01 01 01 01 01 01 01 01 01 01 01 01 01 01 01
01 00 00 00 00 00 00 00 00 00 00 00 07 01 00 00 01 01 00 01 01 00 91 01
01 06 00 00 00 00 00 00 00 00 00 00 00 01 00 00 01 00 09 00 01 00 00 01
01 00 00 00 00 00 01 01 00 00 00 00 01 01 00 00 00 00 00 00 06 00 00 01
01 00 00 00 00 00 01 00 00 06 00 00 07 01 00 00 06 00 00 00 00 00 00 01
01 00 00 00 00 00 01 07 00 00 00 00 02 02 00 00 00 00 04 00 00 00 00 01
01 00 00 00 00 00 06 01 00 00 00 06 01 01 01 01 01 01 00 01 01 01 01 01
01 00 00 00 00 00 01 01 00 00 00 00 01 01 00 00 00 01 00 01 00 00 00 01
01 00 00 00 00 00 01 01 00 00 00 00 00 01 00 00 01 01 00 01 01 00 00 01
01 00 00 00 00 00 00 01 06 00 00 00 07 07 00 00 00 00 00 00 00 00 00 01
01 00 00 00 00 00 06 07 00 00 00 00 00 01 00 00 00 00 00 00 00 00 00 01
01 00 00 00 00 00 00 01 00 00 00 00 01 01 00 00 00 00 00 00 00 00 00 01
01 00 00 00 00 00 01 01 00 00 00 00 01 01 00 00 00 00 00 00 00 00 00 01
01 00 00 00 00 00 01 01 00 00 00 00 01 01 00 00 06 00 01 01 01 01 01 01
01 00 00 00 00 00 01 01 00 00 00 00 01 01 00 00 00 00 01 00 01 07 05 01
01 00 00 00 00 00 01 01 00 00 00 00 07 01 00 00 00 00 01 00 00 00 00 01
01 00 00 08 00 00 01 00 00 00 06 00 00 01 00 00 00 00 01 04 01 01 00 01
01 00 00 00 00 00 07 01 00 00 00 00 00 00 00 00 00 00 01 00 01 00 00 01
01 00 00 00 00 00 00 01 00 00 00 00 00 00 00 00 00 06 00 00 01 07 90 01
01 01 01 01 01 01 01 01 01 01 01 01 01 01 01 01 01 01 01 01 01 01 01 01
