01 01 01 01 01 01 01 01 01 01 01 01 01 01 01 01 01 01 01 01 01 01 01 01
01 01 01 01 01 01 01 01 01 07 00 01 01 00 00 01 09 00 00 00 00 00 90 01
01 01 00 00 07 00 07 01 01 00 00 00 08 00 30 01 01 01 01 01 07 00 01 01
01 01 00 07 00 00 00 01 01 00 00 00 00 00 00 01 00 00 00 00 00 00 00 01
01 01 00 00 00 07 00 01 01 00 07 01 01 00 00 01 00 07 01 01 01 01 01 01
01 01 07 00 09 00 07 01 01 00 00 01 01 00 00 01 00 00 00 00 00 00 00 01
01 01 00 00 00 00 00 02 02 00 00 07 01 00 00 01 01 01 01 01 07 00 01 01
01 01 07 00 00 07 00 01 01 00 00 00 34 00 00 00 00 00 00 00 00 00 00 01
01 01 00 07 00 00 07 01 01 30 00 01 01 00 00 01 01 00 07 01 01 01 01 01
01 01 01 01 01 01 01 01 01 00 00 01 01 00 00 00 00 00 00 00 00 00 00 01
01 01 01 01 01 01 01 01 01 00 01 01 01 07 00 01 01 01 01 01 01 01 01 01
01 00 00 00 00 34 00 00 00 00 00 00 00 00 00 00 00 00 00 00 00 00 00 01
01 00 01 01 01 00 00 01 00 00 00 00 01 01 01 00 00 01 00 00 01 00 00 01
01 00 01 00 01 00 00 01 00 00 00 01 00 00 00 01 00 01 00 07 01 07 00 01
01 00 01 01 01 00 00 01 00 00 00 01 01 01 01 01 07 01 00 00 01 00 00 01
01 00 01 00 09 01 00 01 00 00 00 01 00 09 00 01 91 01 07 00 01 00 30 01
01 00 01 00 00 01 07 01 00 00 00 01 00 00 07 01 00 01 00 05 01 00 00 01
01 00 01 01 01 01 00 01 01 01 07 01 07 00 00 01 00 01 01 01 01 00 00 01
01 00 00 00 00 00 00 00 00 00 00 00 00 00 00 00 00 00 34 00 00 00 00 01
01 01 01 01 01 01 01 01 01 01 01 01 01 01 01 01 01 01 01 01 01 01 01 01
