01 01 01 01 01 01 01 01 01 01 01 01 01 01 01 01 01 01 01 01 01 01 01 01
01 01 01 01 01 01 01 01 01 00 00 08 00 00 00 01 01 01 01 01 01 01 01 01
01 01 01 01 01 01 01 01 01 00 00 00 00 00 00 01 01 01 01 01 01 01 01 01
01 01 01 01 01 01 01 01 01 00 00 00 00 06 00 01 01 01 01 01 01 01 01 01
01 01 01 00 00 00 00 00 00 00 00 00 00 00 00 00 00 00 00 06 00 01 01 01
01 01 01 91 00 00 00 00 06 00 00 00 00 00 00 00 00 00 00 00 00 01 01 01
01 01 01 00 00 06 00 00 00 00 00 00 00 00 00 00 00 00 00 00 90 01 01 01
01 01 01 00 00 00 00 00 00 00 00 00 00 00 00 00 06 00 00 00 00 01 01 01
01 01 01 01 01 01 01 01 01 00 06 00 00 00 00 01 01 01 01 01 01 01 01 01
01 01 01 01 01 01 01 01 01 00 00 00 06 00 00 01 01 01 01 01 01 01 01 01
01 01 01 01 01 01 01 01 01 00 00 00 00 00 00 01 01 01 01 01 01 01 01 01
01 01 01 01 01 01 01 01 01 06 00 00 00 00 00 01 01 01 01 01 01 01 01 01
01 01 01 01 01 01 01 01 01 00 00 00 00 00 06 01 01 01 01 01 01 01 01 01
01 01 01 01 01 01 01 01 01 00 00 00 00 00 00 01 01 01 01 01 01 01 01 01
01 01 01 01 01 01 01 01 01 00 00 00 00 06 00 01 01 01 01 01 01 01 01 01
01 01 01 01 01 01 01 01 01 01 01 00 01 01 01 01 01 01 01 01 01 01 01 01
01 01 01 01 01 01 01 01 01 00 00 00 00 00 00 01 01 01 01 01 01 01 01 01
01 01 01 01 01 01 01 01 01 00 00 04 00 00 00 01 01 01 01 01 01 01 01 01
01 01 01 01 01 01 01 01 01 00 00 00 09 00 00 01 01 01 01 01 01 01 01 01
01 01 01 01 01 01 01 01 01 01 01 01 01 01 01 01 01 01 01 01 01 01 01 01
