01 01 01 01 01 01 01 01 01 01 01 01 01 01 01 01 01 01 01 01 01 01 01 01
01 00 00 00 01 01 01 00 00 00 01 00 00 00 00 00 00 00 00 00 00 00 06 01
01 00 08 00 01 01 01 00 01 00 01 00 01 00 00 00 01 01 00 01 00 01 07 01
01 00 00 00 00 00 01 00 01 00 01 00 01 01 01 00 01 00 00 01 00 00 00 01
01 00 01 00 01 00 00 00 01 00 01 00 06 00 01 00 01 00 01 01 01 01 01 01
01 00 01 01 01 01 01 01 01 00 01 00 01 00 01 00 01 00 01 00 00 00 00 01
01 00 00 00 00 00 00 00 01 00 01 00 01 00 01 00 01 00 01 00 01 00 00 01
01 00 01 00 00 01 00 02 01 00 01 00 01 00 01 00 01 00 00 00 01 00 00 01
01 00 01 00 00 01 07 09 01 00 00 00 01 00 01 01 01 01 07 01 01 00 00 01
01 00 01 00 00 01 01 01 01 01 01 01 01 00 00 01 00 00 00 01 00 00 00 01
01 00 01 01 01 01 00 00 00 00 00 00 01 00 01 01 00 01 01 01 00 01 01 01
01 00 00 01 00 00 00 01 01 01 01 00 01 07 00 00 00 00 00 00 00 02 90 01
01 00 00 01 00 01 91 07 01 01 01 07 01 01 00 01 01 01 01 01 01 01 00 01
01 00 00 01 00 01 01 01 01 00 01 00 00 00 00 01 00 00 00 01 00 00 00 01
01 00 01 01 00 00 06 00 00 00 01 01 01 00 01 01 00 01 01 01 00 01 01 01
01 00 01 07 00 00 00 00 01 00 01 00 00 00 01 00 00 00 00 00 00 01 01 01
01 00 01 09 07 01 01 01 01 00 01 00 01 01 01 00 01 01 00 01 00 00 00 01
01 00 01 01 01 01 00 00 00 00 01 00 00 00 00 00 01 07 00 01 04 09 00 01
01 00 00 00 00 00 00 01 01 01 01 00 01 01 01 07 01 00 00 01 00 00 00 01
01 01 01 01 01 01 01 01 01 01 01 01 01 01 01 01 01 01 01 01 01 01 01 01
