1 1 1 1 1 1 1 1 1 1 1 1 1 1 1 1 1 1 1 1 1 1 1 1
1 0 0 0 1 1 1 0 0 0 1 0 0 0 0 0 0 0 0 0 0 0 0 1
1 0 8 0 1 1 1 0 1 0 1 0 1 0 0 0 1 1 0 1 0 1 7 1
1 0 0 0 0 0 1 0 1 0 1 0 1 1 1 0 1 0 0 1 0 0 0 1
1 0 1 0 1 0 0 0 1 0 1 0 0 0 1 0 1 0 1 1 1 1 1 1
1 0 1 1 1 1 1 1 1 0 1 0 1 0 1 0 1 0 1 0 0 0 0 1
1 0 0 0 0 0 0 0 1 0 1 0 1 0 1 0 1 0 1 0 1 0 0 1
1 0 1 0 0 1 0 2 1 0 1 0 1 0 1 0 1 0 0 0 1 0 0 1
1 0 1 0 0 1 7 9 1 0 0 0 1 0 1 1 1 1 7 1 1 0 0 1
1 0 1 0 0 1 1 1 1 1 1 1 1 0 0 1 0 0 0 1 0 0 0 1
1 0 1 1 1 1 0 0 0 0 0 0 1 0 1 1 0 1 1 1 0 1 1 1
1 0 0 1 0 0 0 1 1 1 1 0 1 7 0 0 0 0 0 0 0 2 0 1
1 0 0 1 0 1 1 1 1 1 1 7 1 1 0 1 1 1 1 1 1 1 0 1
1 0 0 1 0 1 1 1 0 0 1 0 0 0 0 1 0 0 0 1 0 0 0 1
1 0 1 1 0 0 0 0 0 0 1 1 1 0 1 1 0 1 1 1 0 1 1 1
1 0 1 7 0 0 0 0 1 0 1 0 0 0 1 0 0 0 0 0 0 1 1 1
1 0 1 9 7 1 1 1 1 0 1 0 1 1 1 0 1 1 0 1 0 0 0 1
1 0 1 1 1 1 0 0 0 0 1 0 0 0 0 0 1 7 0 1 0 9 0 1
1 0 0 0 0 0 0 1 1 1 1 0 1 1 1 7 1 0 0 1 0 0 0 1
1 1 1 1 1 1 1 1 1 1 1 1 1 1 1 1 1 1 1 1 1 1 1 1
